1111111111111111111111111
10PCCCCCCCCCCCCCCCCCCCCE1
1111111111111111111111111
